1111111111111111111111111111111111111111
0000000000000000000000000000000000000000
0000000000000000000000000000000000000000
0000000222200000000000022220000000000000
0000000222200000000000022220000000000000
0000000222200000000000022220000000000000
0000000222200000000000022220000000000000
0000000022220000000000002222000000000000
0000000222200000000000022220000000000000
0000000222200001111000022220000000000000
0000000222200000000000022220000000000000
0000000222200000000000022220000000000000
0000000000000000000000000000000000000000
0002200000000000000000000000022000000000
0000022000000000000000000002200000000000
0000000220000000000000002220001111110000
0000000002200000000000222000000001000000
0011111000022220000222000000000001000000
0000000000000002222000000000000001000000
0000000000000000000000000000000001000000
0000000000000000000000000000000000000000
0000000000000000000000000000000000000000
0000000000000000000011111111111100000000
1111000000000000000000000000000000000000
0000001111110000000000000000000000000000