1111111111111111111111111111111111111111
0000000000000000000000000000000000000000
0000000000000000002000000000000000000000
0000000000000000022200000000000000000000
0000000000000000222220000000000000000000
0000000000000002222222000000010000000000
0000000000000000002000000000222000000000
0000000000000000002000000000212000000000
1111111111000000002000000020111000000000
0000000000000000002000000222010000000000
0000000000000000222220000010111000000000
0000000000000000000000000001010100000000
0000000000000000000000000000010010000000
0000000001111111100000000000010000000000
0000000000000000000000000000101000000000
0000000000022111111110000001000100000000
0000111112200000000000000010000010000000
0000000011111000000000000000000000000000
0000001000000000000000000000000000000000
0000001000000001111111111110000000000000
0000001000000000000000000000000000000000
0000001000000000000000000000000000000000
0000001001111111111111100000000000000000
0000000000000000000000000000000000000000