1111111111111111111111111111111111111111
0000000000000000000000000000000000000000
0000000000000000000000000000000000000000
0000000222200000000000022220000000000000
0000000222200000000000022220000000000000
0000000222222211111122222220000000000000
0000000222200000000000022220000000000000
0000000000000000000000000000000000000000
0000000222200000000000022220000000000000
0000000222200000000000022220000000000000
0000000222200000000000022220000001000000
0000000222200011111100022220000001000000
0000000000000000000000000000000001000000
0001111000000000000000000000000001000000
0000000000000000000000000000000001000000
0000000000000000000000000000000001000000
0000000000000000000000000000000001000000
0000000000000000000000000000000221220000
0001111111111100000000000000011111111100
0000000000000000000000000000000222200000
0000000000000000000000000000000022000000
0000000000000000000000000000000022000011
0000000000000000000000000000000222200011
0000000111110000000000000000000000000011
0000000000000000000000000000000000000000